māy	I
attu	you
ho	he/she/it/they (distal)
he	he/she/it/they (proximal)
peter	boy
šorko	boy
šurki	girl
kozoro	man
zayfā	woman
mers	husband
miri	wife
kotoro	dog
gārbo	cat
fil	elephant
gazzi	rope
gohro	horse
āno	egg
čuki	chicken
tʰal	mountain
olu	potato
karen	to do